000000000000000000000060000000000000000000000000000000000000000000006
000000000000000000000060000000000000000000000000000000000000000000006
000000000000000000000060000000000000000000000000000000000000000000006
000000000000000000000060000000000000000000000000000000000000000000006
000000000000000000000060000000003000000000000083300000000000000000006
000000002220000000000060000050003000000000000083300000000000000000000
000002001110000000000060008222222222280000000083300000000000000000000
022200000000020000005060008000000000080000000083300000000000000000000
011100000000000000002220008000000000022220022222222200000000000000000
011103000000000200001110008000000000011110011111111100000000000000006
000003300000000000021112000000000000000000055555551100000000000000006
000000330000000002000000000000000000000000000000051100000000000000006
000000000200000000000000020000000000000000200000051100000000000000006
000000000200000000000000000200000000000000055000051100000000000000006
000000002220000000000000000002000000000000015555052222222000222222222
000000001110000000000000222000000000000000011115051110000003111111111
000000022222000000000008111000000000000000011115050000000000333333331
000003011111000110000008000000000000000000000000000000003000000000001
222033011111000000000008000000000000000000000000000003000000000000001
111444411111444444411111444444422244422244243333333444444443333333331






















